1111111111111
1P110000000C1
1E00011111001
1C00110000001
1111111111111
