111111111111111111111111111111111111111
100000010C000M0000000K000011000C0M01111
101000010010000010100000010100100000011
1111010101010010010M0001000000000000011
100101110010111110100000000000000111111
100P00000C0000000000000MC0000000M0000M1
1E000001010101011011010100010000M000001
111111111111111111111111111111111111111
